'w','e',0,4;
'w','e',1,4;
'w','n',2,4;
's','n',2,3;
's','e',2,2;
'w','e',3,2;
'w','e',4,2;
'w','e',5,2;
'w','e',6,2;
'w','e',7,2;
'w','e',8,2;
'w','e',9,2;
'w','s',10,2;
'n','s',10,3;
'n','s',10,4;
'n','s',10,5;
'n','s',10,6;
'n','w',10,7;
'e','w',9,7;
'e','w',8,7;
'e','w',7,7;
'e','w',6,7;
'e','w',5,7;
'e','w',4,7;
'e','w',3,7;
'e','n',2,7;
's','n',2,6;
's','w',2,5;
'e','w',1,5;
'e','w',0,5;
'e','w',-1,5;